1111111111111
1C00000000001
1000000000001
1P0011E000C11
1111111111111



